map: 9 7
8 8 8 8 8 8 8 8 8
8 0 0 0 0 0 0 0 8
8 0 4 0 0 0 9 0 8
8 0 0 0 0 0 0 0 8
8 0 5 0 0 0 3 0 8
8 0 0 0 0 0 0 0 8
8 8 8 8 8 8 8 8 8
pos: 1.5 1.5
dir: 1 0
por: 2 2 0 2 2 1
