map: 11 6
8 8 8 8 8 8 8 8 8 8 8
8 0 0 0 0 0 0 0 0 0 8
8 0 0 3 0 0 0 0 0 0 8
8 0 3 3 0 0 0 0 0 0 8
8 0 0 0 0 0 0 0 0 0 8
8 8 8 8 8 8 8 8 8 8 8
pos: 1.5 1.5
dir: 1 0
por: 0 0 -1 0 0 -1
